NL -> D]
[blz 100]
de baan = der job
het bedrijf = der betrieb 
het beroep = der Beruf
het verschil = der unterschied
de beslissing = die Entscheidung
het examen = die Prüfung
de firma = die firma 
de opleiding = die Ausbildung 
de toekomst = die Zukunft
het buitenland = das Ausland
het eindexamen(vwo) = das Abitur
het kantoor = das Büro
de stage = das Praktikum
de studie = das studium

horen, vernemen = erfahren
kiezen voor = sich entscheiden für / entschieden
leiden = leiten
merken = merken 
onderzoeken = forschen
oprichten = gründen
passen bij = passen zu
zich aanmelden = sich aanmelden
afwisselend = abwechslungsreich
verschillende = verschiedene
aan de andere kant = andererseits
aan de ene kant = einerseits
daarbij = dabei
daardoor = dadurch
eerst = erstmal
genoeg, voldoende = genügend
meteen, onmiddellijk = sofort
tijdens, terwijl = während
zowel ... als ook = sowohl ... als auch

[blz 101]
de medewerker = der mitarbeiter
de advertentie = die anzeige
het cijfer = die note
de ervaring = die Erfahrung
de sollicitatie = die Bewerbung
het doel = das ziel 
het voorbeeld = das beispiel
de gegevens = die daten
de kennis = die Kenntnisse
van tevoren, bij voorbaat = im voraus
downloaden = herunterladen
duren = dauern
geïnteresseerd zijn in = interesse haben an
halen, met goed gevolg afleggen = bestehen - bestanden
makkelijk afgaan = leichtfallen - leichtgefallen
moeilijk afgaan, niet meevallen = schwerfallen - schwergefallen
ontwikkelen = entwickeln
produceren = herstellen
werkzaam zijn = tätig sein
laag = niedrig
nieuwsgierig = neugierig 
tolerant = tolerant 
deeltijd = teilzeit 
eerst, aanvankelijk = zunächst
hoog = hoch
meteen = gleich
onder andere = unter anderem
op deze manier = auf diese weise
op dit gebied = auf diesem Gebiet
pas = erst 
volgens = laut



[D -> NL]
[blz 98 B1]
neulich = onlangs
das autogramm = de handtekening
der Staatsanwalt = de officier van justitie
der Widerspruch = de tegenstelling
die Genehmigung = de toestemming, de vergunning
bedürfen = nodig hebben
die Klausur = het tentamen, de toets 
das Dasein = het bestaan
nebenbei = daarnaast

[blz 99 G]
das Geräusch = het geluid
rutschen = afzakken, glijden
auftauchen = opduiken
de Forderung = de eis 
der Anspruch = de eis 
dennoch = toch
sich fürchten vor = bang zijn voor 
betrachten = observeren, bekijken
der Mangel = het gebrek
geeignet = geschikt
schätzen = waarderen 
enttäuschen = teleurstellen

[blz 146 A2-B1]
sich trennen von = afstand doen van
etwas loswerden = van iets af willen, iets kwijt willen 
am Herzen liegen = waardevol zijn
die Erleichterung = de opluchting
verfügbar = beschikbaar, ter beschikking 
zusätzlich = extra
bereuen = spijt hebben van
stattdessen = in plaats daarvan
verrückt = gek, krankzinnig
ablehnen = afwijzen, afkeuren
zwangsläufig = onvermijdelijk, vanzelf
insbesondere = in het bijzonder, vooral
überlegen = overdenken, overwegen

die Miete = de huur
die Nachhaltigkeit = de duurzaamheid
de Absicht = de bedoeling, intentie
die Ausstattung = de inrichting
verringern = verminderen
sich beschränken auf = zich beperken tot 
überflüssig = overbodig
der Rohstoff = de grondstof 
gemäß = volgens
sich beziehen auf = betrekking hebben op 

[blz 147 B2-G]
der Rausch = de roes
begegnen = ontmoeten 
die Klamotten = de kleren 
die Spende = de gift, de donatie 
der Reiz = de prikkel 
sich etwas borgen = iets lenen 
deswegen = daarom 
der Vorzug = het voordeel 
zweckentfremden = voor een verkeerd doel gebruiken
das Bedürfnis = de behoefte 
erzeugen = genereren, opwekken
fehlen = missen

etwas entgegensetzen = iets tegenoverstellen 
die Reichweite = het bereik, de reikwijdte
herangehen an = aanpakken, benaderen 
aussteigen = afhaken, uitstappen 
die Fertigung = de fabricage, de productie 
niedrig = laag
etwas verwerfen = iets verwerpen, iets afwijzen 
etwas umsetzen = iets omzetten, iets verwezenlijken 
scheitern = falen, mislukken 
die Grundlagen = de basis, de grondbeginselen 
der Reißverschluss = de ritssluiting 
langfristig = op lange termijn 
ersteigern = op een veiling kopen 

die Ausrede = de smoes
bequem = comfortabel 
sich verhalten = zich gedragen 
der Nutzer = de gebruiker 
bewerten = beoordelen, punten geven 
umwandeln = omzetten 
der Rabatt = de korting 
überprüfen = controleren 
verfügbar = beschikbaar
die Herausforderung = de uitdaging 
verwenden = gebruiken
ausreichen = voldoende zijn 
langfristig = langdurig 
das Misstrauen = het wantrouwen

[blz 98 A1-A2; blz 99 B2-F; 146 A1]
https://studygo.com/nl/learn/folders/2230575
