der Zweck =  het doel
etwas verpassen =  iets missen
sich kümmern um =  zich bekommeren om
seinerzeit =    destijds
sogar =   zelfs
das Vergnügen = het plezier, het vermaak
nach wie vor =  nog steeds
die Mess =   de beurs
ehrgeizig =  ambitieus
nach und nach = beetje bij beetje 
die Gegenwart =    de tegenwoordige tijd
die Sinne =  de zintuigen
die Versuchung =   de verleiding
sich erweisen als =   bijken te zijn
gelingen =   lukken
die Geschwindigkeit = de snelheid
de Beschleunigung =   de versnelling
ausnutzen =  gebruiken
die Voraussetzung =   de voorwaarde
erforschen = onderzoeken
beziehungsweise =  ofwel
die Absicht =   de bedoeling
der Hinweis =   de aanwijzing
sich irren =    zich vergissen
die Grundlage = de basis
der Begzug =    de betrekking
der alltag =    het alledaagse leven
bisher =  tot nu toe 
bestehen auf =  beweren
tatsächlich =   daadwerkelijk
drohen =  dreigen
nah =  dichtbij
vergangen =     afgelopen
das Jahrzehnt =    het decennium
klug =    slim




de tijd =    der zeit
afspreken =  sich verabreden
afzeggen =   absagen
duren dauern
er is, er zijn =   es gibt
krijgen = bekommen 
langsgaan =  vorbeigehen
nadenken =   nachdenken
plattsvinden =  stattfinden
vinden van =    halten von
voorstellen =   vorschlagen
vragen =  fragen
wachten =    warten
zin hebben in =    lust habben auf
inspanned, vermoeiend =  anstrengend
moeilijk, lastig = schwierig
verrassend = Überraschend
aansluitend =   anschließend
als, in het geval dat =  falls
desondanks, toch =    trotzdem
echter =  allerdings
eens = mal
geen idee =  keine ahnung
iets etwas 
maandelijks =   monatlich
makelijk, gewoon =    einfach
meteen =  sofort
nauwelijks =    kaum
of ... of =  entweder ... oder
stipt =   pünktlich
tenslotte =  schließlich
toch =    doch
wekelijks =  wöchenlich
aanbevelen =    empfelen
begrijpen =  verstehen
enthousiast zijn over =  begeistert sein von 
instemmen, het er mee eens zijn = zustimmen
laten zien =    zeigen
vertellen =  erzählen 
zeggen =  sagen 
geweldig =   großartig
indrukwekkend = keeindruckend
onbeslist, gelijkspel =  unentschieden
ongeloofelijk =    unglaublich
spannend =   spannend
verschrikelijk =   schrecklich
vreselijk =  furchtbar
enigszins =  einigermaßen
heel, helemaal =   ganz
met name, vooal =  besonders
onafgebroken =  pausenlos
onlangs = neulich
